111111111111111111
1......1......1B.1
1................1
1...1.....1....111
11...............1
1..P.......111...1
1B...1......BB...1
1................1
1.....1.......1111
1.....1...1....BB1
111111111111111111
